11111111111111111111
1P000000000000000001
10111111011110111111
10000001000000100001
100C1110111110111001
10000000000000000001
10111011101110111011
1000000000C000E00001
1C011101111101110111
11111111111111111111
